PPPXXXXXXXXXXX_____XXXXXXXXXXXXXXXXX
P__________________________________P
P__________________________________P
X___XXXX___________________________P
X___X__X_________C__________________
X___XXXX__________________G_________
P___________________________________
P__________________________________X
P_______________B1_________________X
P__________________________________X
P__________________________________X
PPPXX__d1_XXXXXXXXXXXXPPPPPPPPPPPPPX
