PPPXXXXXXXXXXX_____XXXXX
P______________________X
P______________________X
X___XXXX_______________X
X___X__X_______________X
X___XXXX_______________X
X______________________P
X______________________P
X_____________________PP
P_____________________P_
PPPXX_____XXXXXXXXXXXXP_