PPPXXXXXXXXXXX_____XXXXXXXXXXXXXXXXX
P__________________________________X
P__________________________S_______X
X___XXXX___________________________P
X___X__X____________________________
X___XXXX___________________K________
P___________________________________
P__________________________________X
P__________________________G_______X
P__________________________________X
P__________________________________X
PPPXX_____XXXXXXXXXXXXPPPPPPPPPPPPPX
