XXXXXXXXXXXXXXX______XXXXXXXXXXXXXXX
X__________________________________X
X__________________________________X
X__________________________________X
X__________________________________X
X__________________________________X
X_____K________________b___________X
X__________________________________X
X__________________________________X
X_____K____________________________X
X__________________________________X
X__________________________________X
XXXXXXXXXXXXXXXXXXXXXXXXXXXXXXXXXXXX