PPPXXXXXXXXXXX_____XXXXXXXXXXXXXXXXX
P__________________________________X
P__________________________S_______X
X___XXXX___________________________P
X___X__X_____C______________________
X___XXXX___________________K________
P___________________________________
P__________________________________X
P_______________B1_________G_______X
P__________________________________X
P__________________________________X
PPPXX__d1_XXXXXXXXXXXXPPPPPPPPPPPPPX
