PPPXXXXXXXXXXX_____XXXXXXXXXXXXXXXXX
P__________________________________X
P__________________________________X
X___XXXX___________________________P
X___X__X___________________________P
X___XXXX___________________K_______P
P__________________________________X
P__________________________________X
P__________________________________X
P__________________________________X
P__________________________________X
PPPXX_____XXXXXXXXXXXXPPPPPPPPPPPPPX
