PPPXXXXXXXXXXX_____XXXXXXXXXXXXXXXXX
P__________________________________P
P____________T_____________________P
X___XXXX_________________FFFF______P
X___X__X_____C______________________
X___XXXX___________________K________
P___________________________________
P__________________________________X
P_______________B1_________G___S___X
P__________________________________X
P__________________________________X
PPPXX__d1_XXXXXXXXXXXXPPPPPPPPPPPPPX
