XXXXXXXXXXXXXXXXXXXXXXXXXXXXXXXXXXXX
X__________________________________X
X__________________________________X
X_____T______________________T_____X
X__________________________________X
X___________________________________
X________________K__________________
X___________________________________
X__________________________________X
X_____T______________________T_____X
X__________________________________X
X__________________________________X
XXXXXXXXXXXXXXX______XXXXXXXXXXXXXXX