XXXXXXXXX__L__XXXXXXXXXX
X______________________X
_______________________X
________PPPPPPPPPP_____X
________P________P_____X
________PPPPPP___P_____X
X____________P___P_____X
X____________PPPPP_____X
X______________________X
X______________________X
XXXXXXXXXXXXXX_____XXXXX