XXXXXXXXXXXXXXX______PPPPXXXXXXXXXXX
X_______W__________________W__W__W_X
L_______W__________________W_______X
X_______W__________________W_______P
P______W_W________________W_W______P
P______W_W________________WW_______X
P______WWW________________W_W______L
P______W_W________________WW_______X
P______W_W________________WW_______P
P__WW__WWW________________W_W______P
X_W__W_WWW_________________W_______P
X_W_W__W_W_______________W__W_WW_W_X
XXXXXXXXXXXPPPP______XXXXXXXXXXXXXXX
