XXXXXXXXXXXXXXX______PPPPXXXXXXXXXXX
X_W__W__W___________________W__W__WX
XW__W_W_W__________________W__W_W_WX
P_______W__________________W_______P
P______W_W________________W_W______P
_______W_W________________WW_______
L______WWW________________W_W______L
_______W_W________________WW_______
P______W_W________________WW_______P
P_______WW_________________W_______P
XW__W___W__________________W__W__W_X
X_W__W__W_________________W__W_WW__X
XXXXXXXXXXXPPPP______XXXXXXXXXXXXXXX
