XXXXX_____XXXXXXPPPPPPPX
X_____________X_________
______________X_________
______________X________X
______________X_W_W__W_X
X_____________X_W__W_W_X
X_____________X________X
X______________________X
X______________________X
X______________________X
XXXXXXXXXXXXXXXPPPPPPPPX