XXXXX_____XXXXXXPPPPPPPX
X_____________X________X
______________X___S____X
______________XXX_d0_XXX
_______C______X________X
X_____________X_W__W_W_X
X_____________X________X
X______________________X
X_____B0_______________X
X______________________X
XXXXXXXXXXXXXXXPPPPPPPPX