XXXXXXXXXXXXXX___E____XXXXXXXXXXXXX
X__________________________________X
X__________________________________X
X_____T______________________T_____X
X__________________________________X
X__________________________________X
X________________K_________________X
X___________________________________
X___________________________________
X_____T_____________________________
X__________________________________X
X__________________________________X
XXXXXXXXXXXXXXX______XXXXXXXXXXXXXXX