XXXXXXXXXXXXXXXXXXXXXXXXXXXXXXXXXXXX
XXXX_______________________________X
XXX_________________________________
XX__________________________________
X___________________________________
X___K_______________________________
X__________________________________X
X__________________________________X
XX_________________________________X
XXX________________________________X
XXXX_______________________________X
XXXXXXXXXXXXXXXXXXXXXXXXXXXXXXXXXXXX
