XXXXXXXXXXXXXXXXXXXXXXXXXXXXXXXXXXXX
XXXX_______________________________X
XXX_________________________________
XX__________________________________
X___________________________________
X___G_______________________________
X__________________T_______________X
X__________________________________X
XX_________________________________X
XXX________________________________X
XXXX_______________________________X
XXXXXXXXXXXXXXXXXXXXXXXXXXXXXXXXXXXX
