XXXXXX_____XXXXX____________________
X______________P____________________
X______________P_XXXXXXXXXXXXXXXXXXX
X______________P_X_________________X
X______________P_X_________________X
X_W__W__W__W___X_X__________________
X__W___W_W__W__X_X__________________
_______________XXX__________________
___________________________________X
___________________________________X
X_________________________________XX
X_______________________________XXX_
XXPPPPPPPPPPXXXXXXXXXXXXXXXXXXXXX___