XXXXXXXXXXXXXXXXXXXXXXXX
X______________________X
X_______________________
X_______________________
X___________W___________
X_______________________
X______________________X
X______________________X
X______________________X
X______________________X
XXXXXXXXXXXXXXXXXXXXXXXX