XXXXXXXXXXXXXXXXXXXXXXX__L__XXXXXXXX
P________________X_________________P
P________K_______X_________________P
P________________X_________________P
W__W__W__W__W__W__W__W__W__W__W__W__
_W__W__W__W__W__W__W__W__W__W__W__W_
W__W__W__W__W__W__W__W__W__W__W__W__
X__________________________________P
P__________________________________P
P__________________________________P
P__________________________________P
XXXXXXXXX_____XXXXXXXXXXXXXXXXXXXXXX
