____________________________________
____________________________________
___XXXXXXXXXXXXXXXXXXXXXXXXXXXXX____
___X___________________________X____
XXXX___________B0______________XXXXX
____________________________________
_______________________________D0___
____________________________________
XXXX___________C_______________XXXXX
___X___________________________X____
___XXXXXXXXXXXXXXXXXXXXXXXXXXXXX____
____________________________________
____________________________________
