XXXXXXXXXXXXXXXXXXXXXXX__L__XXXXXXXX
P__________________________________P
P________K_________________________P
P__________________________________P
W__W__W__W__W__W__W__W__W__W__W__W__
_W__W__W__W__W__W__W__W__W__W__W__W_
W__W__W__W__W__W__W__W__W__W__W__W__
X__________________________________P
P________________________K_________P
P__________________________________P
P__________________________________P
XXXXXXXXX_____XXXXXXXXXXXXXXXXXXXXXX
