_______________XXXXXXXXXXXXXXXXXXXXX
_______________XXX_________________X
_______________XXX__________________
XXPPPPPPPPPPPPXXXX__________________
X__________________________________
X_______________D1_________________P
X__________________________________P
X_____K________XXX_________________P
XX_____________XXX_________B1______P
XXXX___________XXX_________________P
XXXXXX_________XXX_________________P
XXXXXXXXXXXXXXXXXXXXXXXXXXXXXXXXXXXP
