XXXXXXXXXXXXXXXXXXXXXXXXXXXXX_______
X___________________________XXX_____
X_____________________________XXX___
X_______________________________XXX_
X_________________________________XX
___________________________________X
___________________________G_______X
___________________________________X
X_________________________________XX
X_______________________________XXX_
X_____________________________XXX___
X___________________________XXX_____
XXXXXXXXXXXXXXXXXXXXXXXXXXXXX_______