_______________XXXXXXXXXXXXXXXXXXXXX
_______________XXX_________________X
_______________XXX__________________
XXPPPPPPPPPPPPXXXX__________________
___________________________________
________________D1_________________P
___________________________________P
_______________XXX_________________P
XX_____________XXX_________B1______P
XXXX___________XXX_________________P
XXXXXX_________XXX_________________P
XXXXXXXXXXXXXXXXXXXXXXXXXXXXXXXXXXXP
