XPPPPPPPPXXXXXXXX_XXXXXXXXXXPPPPPXXX
X__________W_W__X_X__W__W__________X
X__________W_W__X_X__W__W__________X
X__________W_W__XXX__WW_W__________X
X_W__W_W___W____________W_W________X
X_W_W__WW__X____________W_W_________
X__W__W__W_XPPPPPPPPPXXXXXX_________
P__________XXXXXXXXXXXXXX_P_________
P___________WW_W_W__WW__X_P________X
P___________W__WW__W_W__XXX________X
P___________WW_W_W_W__W_W__________X
XXXXXX_____X_W__W__W__W__W_________X
_____X_____XXXXXXXXXXXXXXXXXXXXXXXXX