XXXXXXXXXXXXXXXXXXXXPPPPPPPPPPPPPXXX
X__________________________________X
X__________________________________X
XT_______________________________B0X
X__________________________________X
X__________________________________X
XXXXXXXXXXXXXXXXX___________________
________________X__________________D0
________________X___________________
________________X__________________X
________________X__________________X
________________XXX__________PPPPPPX
