____________________________________
____________________________________
____________________________________
____________________________________
XXXXXXXXXXXXXXXXXXXXXXXXXXXXXXXXXXXX
X__________________________________X
___________________________________X
_______________________K______c____X
___________________________________X
X__________________________________X
XXXXXXXXXXXXXXXXXXXXX__L__XXXXXXXXXX
__________________X_________X_______
