__________________X_________X_______
XXXXXXXXXXXXXXXXXXX_________XXXXXXXX
P__________________________________P
P________T_________________________P
P__________________________________P
W__W__W__W__W__W__W_____________W__W
_W__W__W__W__W__W________________W__
W__W__W__W__W__W__W_____________W__W
X_________________W________________P
X_____B___________W________________P
X_________________W________________P
XXXXXXXXXXXXXXXXXXXXXXX__d__XXXXXXXX
