__________________X_________X_______
XXXXXXXXXXXXXXXXXXX_________XXXXXXXX
P__________________________________P
P________T_________________________P
P__________________________________P
W__W__W__W__W__W__W_____________W__W
_W__W__W__W__W__W________C_______W__
W__W__W__W__W__W__W_____________W__W
P_________________W________________P
P_____B___________W________________P
P_________________W________________P
XXXXXXXXXXXXXXXXXXXXXXX__D__XXXXXXX
