XXPPPPPPPPPPXXXXXXXXXXXXXXXXXXXXXXXX
X______C________W__________________X
X_______________W_________B1_______X
P_W_W__W__W__W__W__________________P
P_W__W__W__W_______________________P
X___________________________________
_____________________PXXXXXXP______L
X____________________P______P_______
XXXXXXXXXXXX_________P______P______P
___________X_W_WW__W_XXXXXXXP______P
___________X_W__W__W_______________X
___________X_W__WW_W_______________X
___________XPPPPPPPPPXXXX__d1_XXXXXX