___________________XXXXX_____XXXX___
___________________P____________X___
___________________P______C_____X___
XXXXXPPPPPPXXXXXXXXXW___W__W__W__XXX
____________________________________
__________________D5____________D5__
____________________________________
XXXXXPPPPPPXXXXXXXXX_W__W___W__W_XXX
__________________P________________X
__________________P_______B5_______X
__________________P________________X
___________________XXXPPPPPPPPXXXXXX
