____________________________________
XXXXXXXXXXXXXPPPPPPPPXXXXXXXXX__d1_X
P__________W_______B1_W____________X
P__________W__________W____________P
P___________XXXXXXXXXXX____________P
_______________W___W_______________X
_______________W___W________M______X
_______________W___W________________
XXXXXXX_____B2_W___W______________D2
______X________W___W________________
______XXPPPPPPXXXXXXXXXPPPPPPPPPPPXX
____________________________________
____________________________________
