____________________________________
XXXXXXXXXXXXXPPPPPPPPXXXXXXXXX_d3_XX
P__________W_______B3_W____________X
P__________W__________W____________P
P___________XXXXXXXXXXX____________P
_______________W___W_______________X
_______________W___W________C______X
_______________W___W_______________X
XXXXXXX___B2___W___W_______________X
______X________W___W________________
______XXPPPPPPXXXXXXXXXPPPP_______D2
__________________________P_________
__________________________PPPPPPPPPX