___________________XXXXX_____XXXX___
___________________P____________X___
___________________P______C_____X___
XXXXXPPPPPPXXXXXXXXX_____________XXX
____________________W___W___W___W___
__________________D___W___W___W_____
____________________W___W___W___W___
XXXXXPPPPPPXXXXXXXXX_____________XXX
__________________X________________P
__________________X_______B________P
__________________X________________P
___________________XXXPPPPPPPPXXXXXX
