___________PPPPPPPPXXXXXXXXXXXXXXXXX
___________X_____________X____c____X
___________X_____________X_________X
___________P_________M___X_F__F__F_X
___________P____________W__________P
___________P____________W__________P
___________X_______XXXXXXXXXXXXXXXXX
___________X_W_W_W_X________________
___________X_______XXXPPPPPPPPPPPPPX
___________X____T__________________X
___________X_______________________X
___________X_______________________X
___________XPPPPPPPPPXXXXXXXXX_____X