____________________________________
____________________________________
____________________________________
XXXXXXXXXXXXXXXXXXXXXXXXXXXXXXXXXXXX
__________________W________________X
__________________W______M__M__M___X
__________________W________________X
XXXXXXXXXXXXXXXXXXXXXXXXXXXXXXXXXXXX
____________________________________
_XXX_X_X_XXX__XXX_X__X_XX___________
__X__XXX_XX___XX__XX_X_X_X__________
__X__X_X_XXX__XXX_X_XX_XX___________