___________PPPPPPPPXXXXXXXXXXXXXXXXX
___________X____________W__________P
___________X____________W__________P
___________P_______b_____X_F__F__F_X
___________P_____________X____c____X
___________P__________b__X_________X
___________X_______XXXXXXXXXXXXXXXXX
___________X_W_W_W_X________________
___________X_______XXXPPPPPPPPPPPPPX
___________X____T_______b__________X
___________X____________b__________X
___________X____________b__________X
___________XPPPPPPPPPXXXXXXXXX_____X