___________PPPPPPPPXXXXXXXXXXXXXXXXX
___________X__________b__X____c____X
___________X___________b_X_________X
___________P_____b_______X_F__F__F_X
___________P____________W__________P
___________P____________W__________P
___________X_______XXXXXXXXXXXXXXXXX
___________X_W_W_W_X________________
___________X_______XXXPPPPPPPPPPPPPX
___________X____T__________________X
___________X_______________________X
___________X____________b__________X
___________XPPPPPPPPPXXXXXXXXX_____X