______________XXXXXXXXPPPPPPPXXXXXXX
______________X____________________X
______________X____C______B9_______X
______________X____________________X
______________X_W__W__W__W__W__W_W_X
XXXXPPPPPXXXXXXX_F__F__F_d9__F__F_FX
X_____________f____________________P
X_____B8______f____________________P
X_____________f__________B9________P
______________f____________________P
______________f____________________P
______________f____________________P
XXXXXXXXXXXXXXXXXXXXXXXPPPPPPX_d8__X