______________XXXXXXXXPPPPPPPXXXXXXX
______________X____________________X
______________X____C______B1_______X
______________X____________________X
______________X_W__W__W__W__W__W_W_X
XXXXPPPPPXXXXXXX_F__F__F__d1_F__F_FX
X_____________F____________________P
X_____B2______F____________________P
X_____________F__________B1________P
______G_______F____________________P
______________F____________________P
______________F____________________P
XXXXXXXXXXXXXXXXXXXXXXXPPPPPX_d2__X