XPPPPXXXXXXXXXXXXXXXXXXPPPPPPX_____X
P________________W__W______________X
P________________W__W______________X
X________________W__W______________X
X_F__F__F__F__F__W__W__W_W_XXXXXXXXX
X_F__F__F__F__F__F__W__W_W_XXXPPPPXX
X__________________________________X
X__________________________________X
XXXXXXXXXXXXXXXX___________________X
________________________________T__X
D1_________________________________X
_______________________B1__________X
XXXPPPPPPPPPXXXXXXXXXXXXXXXXXXXXXXXX