XXXXXXXXXXXXXXXXXPPPPPPXXXXXXXXXXXXX
X_____c_____X_W__________W_X___K___X
X___________X_W____________X_______X
XXXXX_l_XXXXXX_____________XXX__d1_X
P___________W______________________X
P___________W______________________X
P___________W______T_______________P
X_W__W__W__WW______________________P
X___________f______________________P
X___________f___________P___________
X____B1_____f___________P___________
X___________f___________P___________
XXXXXXXXXXXXXXXXXXXXXXXXXXXXXXXXXXXX