XXXXXXXXXXXXXXXXXXPPPPPPX__d1_XXXXXX
X_W__W__W__W__W____________________X
X_W__W__W__W__W____________________X
P_______W__W__W____________________X
P__________W__W__W__W__W__W__W__W__X
P__________W__W__W__W__W__W__W__W__X
___________W__W__W__W_W_W__W_______P
D1_________W_W___T___W__W__W_______P
___________W_W_W__W__W__W__W_______P
X_W__W__W__W_W_W_W_PXXXXXP_W__W__W_P
X_W__B1_W__W__W__W_P_____P_W__W__W_P
X_W__W__W__W__W__W_P_____P_W__W__W_P
XXXXXXXXXXXXXXXXXXXXXXXXXXXXXXXXXXXX