____________________________________
____________________________________
____________________________________
____________________________________
________________________XXXXXXXXXXXX
________________________X__________X
________________________X___________
________________________X____K______
________________________X___________
________________________X__________X
________________________XXXXXXXXXXXX
____________________________________
____________________________________