XXXXXXXXXXXXXXXXXXXXXXXXXXXXXXXXXXXX
X_W_W_W__W_W_W___T__W_W_W_W________X
X_W_W_W_W_W_WW__W__W__W_W_W_________
X_W__W__W__________________________X
X_W__W__W__________________________X
X_W__W__W__W__W__W__W__W__W________X
P_WW__W__W_PPPPPPPPPPPPPPPPPX_F__FFX
P_WW__W__W__W__W__W__W__W__W_______P
XXXXXXXXX_W__W_W__W__W__W__W_______X
X__________W_W_B1_W__W__W__________P
___________W_W_W_W_W_W_____________P
D1_________W_W_W_W_W_W_____________P
XXPPPPPPPPPXXXXXXXXXXXXXXXXXX__d1_XX