XPPPPPPPPXXXXXXXXXXXXXXXXXXXXXXXXXXX
X__W_W_W_W_W_W___T__W_W_W_W_________
X__W_W_W_W_W_WW__WWWW_W_W_W_________
P__W_W_W_W_W________________________
P__W_W_W_W_W_______________________X
P__W_W_W_W_W_W_W_W_W_W_W_W_W_X___FFX
P__W_W_W_WPPPPPPPPPPPPPPPPPPPX_____X
P__W_W_W_W_W_W_W_W_W_W_W_W_W_______P
X__W_W_W_W_W___B1___W_W_W_WW_______P
X_______WW_W_W_W_W_W_W_W_W_W_______P
X_______WW_W_W_W_W_W_W_W_W_W_______X
D1______WW_W_W_W_W_W_WWW__WW_______X
XXPPPPPPXXXXXPPPPPPPPPXXXXXXXX_d1_XX