X__d1_XXXXXXXXXXXXXXXXXXXXPPPPPPPPPX
X_______________W__W______b________P
X__________T____W__W_______________P
X_______________W__W_______________P
X_______________W__W___b_______b___P
XXXXXXX_______XXXXXXXXX_______W__W_X
______X_F__FF_X_______X_______W__W_X
______X_______X___B1__X_______W__W_X
______X_______X_______X_______W__W_X
______X_____________________________
______X_____________________________
______X_____________________________
______XXXXXXXXXXPPPPPPXXXXXXXXXXXXXX