X__d1_XXXXXXXXXXXXXXXXXXXXPPPPPPPPPX
P_______________W__W_______________P
P__________M____W__W_______________P
P_______________W__W_______________P
P_______________W__W_______________P
XXXXXXX_______XXXXXXXXX_______W__W_X
______X_______P_______P_______W__W_X
______X_______P___B1__P_______W__W_X
______X_______X_______X_______W__W_X
______X____________________________X
______X_____________________________
______X_____________________________
______XPPPPPPPPPPPPXXXXXXXXXXXXXXXXX