XXXXXXXXXXXXXXXXXXXXXXXXXXXXXXXXXXXX
X__W__W__W__W__W__W__W__W__W__W__W_X
X_W______________________________W_X
X_W______________________________W_X
X_W______________S_______________W_X
X_W______________________________W_X
X_W______________________________W_X
X_W______________________________W_X
X_W__W__W__W____________W__W__W__W_X
X__________________________________b
X__________________________________b
X__________________________________b
X_____XXXXXXXXXXXXXXXXXXXXXXXXXXXXXX