XXXXXXXXXXXXXXXXXXXXXXXXXXXXXPPPPPPX
X___T___D2________W__W__W__________P
XXXXXXXXX________b_________________P
XPPPPPPPX_____________b____________P
X_W_W__W________b___b______________P
X_W_W__W___________b_______________P
X_W_B1_W__________X__________B2____X
X_W_W__W__________X________________X
X_W_W_____________X_W__W__W__W__WW_X
X_________________X________________X
__________________X___C____________X
__________________X________________X
XXXXXXXXXXXXXXXXXXXXXXPPPPPXXX__d1_X