XPPPPPPPXXXXXXXXXXXXXXXXXXXXXPPPPPPX
X_________W___________W______X_____P
X_________W_____B1____W______X__M__P
X_________W___________W______X_____P
X_________W__W__W__W__W______X_____P
P_________W__W__W__W__W_________C__X
P_________W__W__W__W__W____________X
P_________W__W__W__W__W____________X
P_________W__W__W__W__W____________X
P____________T_____________________X
___________________________________X
__________________T________________X
XXXXXXXXXXXXXXXXXXXXXXXXXXXXXX__d1_X