XXXXXXXXXXXXXXXXXXXXXXXXXXXXXPPPPPPX
X___T___D2b_b______W__W__W_________P
XXXXXXXXX_b_b____b_________________P
XPPPPPPPX_____________b____________P
X_W_W__W________b___b______________P
X_W_W__W___________b_______________P
X_W_B1_W__________X__________B2____X
X_W_W__W__________X________________X
X_W_W_____________X_W__W__W__W__WW_X
__________________X________________X
__________________X___C____________X
__________________X________________X
XXXXXXXXXXXXXXXXXXXXXXPPPPPXXX__d1_X