XXXXXXXXXXXXXXXXXXXXXXXXXXXXXX_____X
P__________W____________W__________P
P____c_____W_____K______W__________P
P__________W____________W__________P
XXXXXXXXXXXXXXXPPPPPPPXXXXXXXXXXXXXX
____________________________________
____________________________________
____________________________________
____________________________________
____________________________________
____________________________________
____________________________________
____________________________________