XXXXXXXXXXXXXXX______XXXXXXXXXXXXXXX
P__________W____________W__________P
P____c_____W_____K______W____K_____P
P__________W____________W__________P
XXXXXXXXXXXXXXXPPPPPPPXXXXXXXXXXXXXX
____________________________________
____________________________________
____________________________________
____________________________________
____________________________________
____________________________________
____________________________________
____________________________________