________________________XXXXX_____XX
________________________X__________X
________________________X__________X
XXPPPPPXXXXXXXXXXXPPPPPPX__________X
X____________F__W__W__W____________P
X_______T____F__W__W__W____________P
X____________F_____W_______________P
P____________F_____W_________B2____X
X__d2___W____XXXX_F__F__F__F__F__F_X
________W___________________________
D1__B1__W___________C______________L
________W___________________________
XXXXXXXXXXXXXXXXXXXPPPPPXXXXXXXXXXXX