XXXXXXXXXXXXXXXXXXPPPPPXXXXXX_____XX
X_W_W__W__W__f__W__W__W____________X
X_W___W__W___f__W__W__W____________X
X____________f__W__W__W____________X
X____________f__W__W__W____________P
X____________f__W__W__W____________P
X_______T____f_____W_______________P
P____________f_____W_________B2____X
X__d2___W____XXXX_F__F__F__F__F__F_X
________W___________________________
D1__B1__W__________________________L
________W___C_______________________
XXXXXXXXXXXXXXXXXXPPPPPXXXXXXXXXXXXX