________________________XXXXX______X
________________________X__________X
________________________X__________X
XXXXXPPPPXXXXXXXXXXXXXXXX__________X
P____________W__W__W__W____________P
P____C_______W__W__W__W____________P
P__________________W_____P_________P
P__________________W_____P___B2____X
X__d2____W_______________P_________X
_________W__________________________
D1___B1__W_____M___________________L
_________W__________________________
XXXXXXXXXXXXXXXXXXXPPPPPPPPPPXXXXXXX