W__W__W__W__W__W__W__W__W__W__W__W_W
W__W__W__W__W__W__W__W__W__W__W_W__W
W__W__W__W__W__W__W__W__W__W__W_W__W
W__W__W__W__W__W__W__W__W__W__W__W_W
W__W__W__W__W__W__W__W__W__W__W__W_W
W__W__W__W__W___XXXXXXXXXXXXX___W__W
WW__W__W__W___XXX_____c______W__W__W
WwW__W__W_WW________________X_W__W_W
_W__W__W_W__W_______________W__W__W_
__W_W__W__W___W_W______________W__W_
W__WW_W__W_W__XXXXX_________________
W__W__W__W__WW__W_X_________________
_W__W___W__W____W_XXXXXXXXXXXXXXXXXX