____________________________________
____________________________________
XXXPPPPPPXXXXXXXXXXXXXXXXXXXXXXXXXXX
X____________________W__W__________X
X____________________W__W__________X
X____________XXXXXXXXXXXXX_________P
X____________X___________X_________P
X_F__F__F__F_X___________X_____c___P
X____________X___________X_________X
_____________XXXXXXXXXXXXX_________X
_________________W__W______________X
_________________W__W______________X
XXXXXXPPPPPXXXXXXXXXXXXXXXXXXXXXXXXX