XXXXXXXXXXXXXXXXXXXXXXXXXXXXXXXXXXXX
X__________________________________X
X__________________________________X
X__________________________________X
X__________________________________X
X__________________________________X
X__________________________________X
X__________________________________X
X__________________________________X
X__________________________________X
X__________________________________X
X__________________________________X
XXXXXXXXXXXXXXX______XXXXXXXXXXXXXXX